41 41 41 41 41 41 41 41 41 41 41 41 41 41 41 41 41 41 41 17 12 12 13 12 12 12 12 12 12 12 18 10 10 10 10 10 31 26 30 10 10 10 10 10 10 10 10 10 10 10 
41 41 41 41 10 41 41 41 41 41 41 41 41 41 41 41 41 10 10 17 12 12 13 12 12 12 12 12 12 12 18 10 10 10 10 10 31 26 30 10 10 10 10 10 10 10 10 10 10 10 
41 41 10 10 10 10 10 10 10 10 41 41 41 41 41 41 10 10 10 17 12 12 12 12 12 12 13 12 12 12 18 10 10 10 10 10 31 26 30 10 10 10 10 10 10 10 10 10 10 10 
41 41 10 10 10 10 10 10 10 10 10 10 41 41 41 41 10 10 10 19 23 12 12 12 12 12 13 12 12 12 18 10 10 10 10 10 10 10 10 10 10 10 10 10 10 10 10 10 10 10 
41 41 10 10 10 10 10 10 10 10 10 10 10 41 41 41 41 10 10 10 17 12 12 12 12 12 12 12 12 22 21 10 10 10 10 10 10 10 10 10 10 10 10 10 10 10 10 10 10 10 
41 41 10 10 11 11 11 10 10 10 10 10 10 41 41 41 41 10 10 10 17 12 12 12 13 12 12 12 12 18 10 10 10 10 10 10 10 10 10 10 10 10 10 10 10 10 10 10 10 10 
41 10 10 10 11 10 10 11 11 10 10 10 10 10 41 41 41 10 10 10 17 12 12 12 13 12 12 12 12 18 10 10 10 10 10 10 10 10 10 10 10 10 10 10 10 10 10 10 10 10 
41 41 10 10 11 10 10 10 11 10 10 10 10 10 41 41 41 10 10 10 19 23 13 12 12 13 12 12 12 18 10 10 10 10 10 10 10 10 10 10 10 10 10 10 10 10 10 10 10 10 
41 41 10 10 11 10 10 10 10 10 10 11 10 10 41 41 41 10 10 10 10 17 12 12 12 13 12 12 22 21 10 10 10 10 10 10 10 10 10 10 10 10 10 10 10 10 10 10 10 10 
41 41 10 10 11 10 10 10 10 10 10 11 10 10 41 41 41 41 10 10 10 17 12 12 12 13 12 12 18 10 10 10 10 10 10 10 10 10 10 10 10 10 10 10 10 10 10 10 10 10 
41 41 10 10 10 10 10 11 10 10 10 11 10 10 10 41 41 41 10 10 10 17 12 12 12 12 12 12 18 10 10 10 10 10 10 10 10 10 10 10 10 10 10 10 10 10 10 10 10 10 
41 10 10 10 10 10 10 11 10 10 10 10 10 10 10 41 41 41 10 10 10 17 12 12 12 12 12 12 24 16 10 10 10 10 10 10 10 10 10 10 10 10 10 10 10 10 10 10 10 10 
41 10 10 10 11 10 10 10 10 10 10 10 10 10 10 41 41 41 10 10 10 17 12 12 12 12 12 12 12 18 10 10 10 10 10 10 10 10 10 10 10 10 10 10 10 10 10 10 10 10 
41 41 10 10 11 10 10 10 10 10 10 10 10 10 10 10 41 41 33 36 14 25 12 12 12 12 12 12 12 18 10 10 10 10 10 10 10 10 10 10 10 10 10 10 10 10 10 10 10 10 
41 41 10 10 10 10 10 11 10 10 10 11 11 10 11 10 41 31 26 30 17 12 12 12 12 12 12 12 12 18 10 10 10 10 10 10 10 10 10 10 10 10 10 10 10 10 10 10 10 10 
41 41 10 10 10 10 10 11 10 10 10 10 11 10 11 10 10 31 26 30 17 12 12 12 12 13 12 12 22 21 10 10 10 10 10 10 10 10 10 10 10 10 10 10 10 10 10 10 10 10 
41 41 10 10 11 10 10 10 11 10 10 10 10 10 11 10 41 31 26 30 17 12 12 12 12 13 12 12 18 10 10 10 10 10 10 10 10 10 10 10 10 10 10 10 10 10 10 10 10 10 
41 10 10 10 10 10 10 10 10 11 10 10 10 11 10 41 41 31 26 30 17 12 12 12 12 13 12 12 18 10 10 10 10 10 10 10 10 10 10 10 10 10 10 10 10 10 10 10 10 10 
41 41 10 11 10 10 10 10 10 10 10 10 10 11 10 41 41 31 26 32 19 23 12 12 12 13 12 22 21 10 10 10 10 10 10 10 10 10 10 10 10 10 10 10 10 10 10 10 10 10 
41 41 10 11 10 10 10 10 11 11 10 10 10 11 10 41 41 37 29 26 30 17 12 12 12 12 12 18 10 10 10 10 10 10 10 10 10 10 10 10 10 10 10 10 10 10 10 10 10 10 
41 41 10 10 10 10 10 10 10 10 10 10 10 11 41 41 41 41 31 26 30 17 12 12 12 12 12 18 10 10 10 10 10 10 10 10 10 10 10 10 10 10 10 10 10 10 10 10 10 10 
41 41 11 10 10 10 10 10 10 10 11 10 10 11 41 41 41 41 31 26 30 17 12 12 12 12 12 18 10 10 10 10 10 10 10 10 10 10 10 10 10 10 10 10 10 10 10 10 10 10 
41 41 10 10 10 10 10 11 10 10 10 10 10 11 41 41 41 41 31 26 30 17 12 12 12 13 12 18 10 10 10 10 10 10 10 10 10 10 10 10 10 10 10 10 10 10 10 10 10 10 
41 41 10 11 10 10 10 10 10 10 11 10 10 11 41 41 41 41 31 26 30 17 12 12 12 12 12 24 16 10 10 10 10 10 10 41 41 41 10 10 10 10 10 10 10 10 10 10 10 10 
41 10 10 10 10 10 10 11 10 10 11 11 10 10 41 41 41 41 31 26 30 17 12 12 12 12 12 12 18 10 10 10 10 10 10 41 41 41 10 10 10 10 10 10 10 10 10 10 10 10 
41 11 10 10 10 10 10 11 10 10 10 11 10 10 10 41 41 41 31 26 30 17 12 12 12 12 12 12 18 10 10 10 10 10 10 41 41 41 10 10 10 10 10 10 10 10 10 10 10 10 
41 10 10 10 10 10 10 10 10 10 10 11 10 10 10 41 41 35 34 26 30 17 12 12 13 12 13 12 18 10 10 10 10 10 10 41 41 41 10 10 10 10 10 10 10 10 10 10 10 10 
41 41 10 10 10 10 11 10 10 10 10 11 10 10 10 41 41 31 26 27 38 17 12 12 13 12 12 12 18 10 10 10 10 10 10 10 10 10 10 10 10 10 10 10 10 10 10 10 10 10 
41 41 10 10 10 10 11 10 11 11 10 10 10 10 10 41 41 31 26 30 14 25 12 12 13 12 12 12 18 10 10 10 10 10 10 10 10 10 10 10 10 10 10 10 10 10 10 10 10 10 
41 41 10 10 10 10 10 10 10 11 10 10 11 10 10 41 41 31 26 30 17 12 12 12 13 12 12 12 18 10 10 10 10 10 10 10 10 10 10 10 10 10 10 10 10 10 10 10 10 10 
41 41 10 10 10 10 10 11 11 10 10 10 10 10 10 41 41 31 53 30 17 12 12 12 12 12 12 22 21 10 10 10 10 10 10 10 10 10 10 10 10 10 10 10 10 10 10 10 10 10 
41 10 10 10 10 10 10 10 10 10 10 10 11 11 10 41 41 31 26 30 17 12 12 12 12 13 12 18 10 10 10 10 41 41 10 10 10 10 10 10 10 10 10 10 10 10 10 10 10 10 
41 41 10 10 10 10 10 10 10 10 10 10 35 33 36 41 41 31 26 30 17 12 13 12 12 13 12 18 10 10 10 10 41 41 41 10 10 10 10 10 10 10 10 10 10 10 10 10 10 10 
41 41 10 10 40 40 40 40 40 53 40 40 31 26 30 41 41 31 26 30 17 12 12 13 13 13 12 18 10 10 10 10 41 41 41 10 10 10 10 10 10 10 10 10 10 10 10 10 10 10 
41 41 10 10 40 50 50 50 50 50 50 40 31 26 30 41 10 31 26 30 17 12 12 13 13 12 22 21 10 10 10 10 41 41 41 10 10 10 10 10 10 10 10 10 10 10 10 10 10 10 
41 41 10 10 40 50 50 50 50 50 50 40 31 26 30 10 10 31 26 30 19 20 20 20 20 20 21 11 10 10 10 10 10 10 10 10 10 10 10 10 10 10 10 10 10 10 10 10 10 10 
41 41 10 10 40 50 50 50 50 50 50 40 31 26 32 33 33 34 26 30 10 11 10 10 11 10 10 10 10 11 10 10 10 10 10 10 10 10 10 10 10 10 10 10 10 10 10 10 10 10 
41 41 10 10 40 51 51 50 50 50 50 40 31 26 26 26 26 26 26 30 14 15 15 15 15 15 15 16 10 10 10 10 10 10 10 10 10 10 10 10 10 10 10 10 10 10 10 10 10 10 
41 10 10 10 40 50 50 50 50 50 50 40 37 28 28 28 28 29 26 30 17 12 12 12 12 12 13 18 10 10 10 10 10 10 10 10 10 10 10 10 10 10 10 10 10 10 10 10 10 10 
41 41 10 10 40 50 50 50 50 50 51 40 10 10 10 11 11 31 26 30 17 12 12 12 12 12 13 18 10 10 10 10 10 10 10 10 10 10 10 10 10 10 10 10 10 10 10 10 10 10 
41 41 10 10 40 50 50 50 50 50 50 40 40 40 10 10 11 31 26 30 17 12 12 12 13 12 12 18 10 10 10 10 10 10 10 10 10 10 10 10 10 10 10 10 10 10 10 10 10 10 
41 41 10 10 40 50 50 50 50 50 50 50 50 40 10 10 10 31 26 30 19 20 23 12 13 12 12 18 10 11 10 10 10 10 10 10 10 10 10 10 10 10 10 10 10 10 10 10 10 10 
41 10 10 10 40 50 50 50 50 50 50 50 51 40 10 10 10 31 26 30 10 10 17 12 13 12 12 18 10 10 10 10 10 10 10 10 10 10 10 10 10 10 10 10 10 10 10 10 10 10 
41 41 10 10 40 51 51 50 50 50 50 50 50 40 10 10 10 37 28 38 11 10 17 12 12 13 12 24 16 10 10 10 10 10 10 10 10 10 10 10 10 10 10 10 10 10 10 10 10 10 
41 10 10 10 40 50 50 50 50 50 50 50 50 40 10 10 11 11 10 10 10 14 25 12 12 12 12 12 24 16 10 10 10 10 10 10 10 10 10 10 10 10 10 10 10 10 10 10 10 10 
41 41 10 10 40 40 40 40 40 40 40 40 40 40 10 10 10 10 10 10 10 17 12 13 12 13 12 12 13 18 10 10 10 10 10 10 10 10 10 10 10 10 10 10 10 10 10 10 10 10 
41 41 41 10 10 10 10 10 10 10 11 10 10 10 10 10 10 11 10 10 10 17 12 12 13 12 13 12 12 18 10 10 10 10 10 10 10 10 10 10 10 10 10 10 10 10 10 10 10 10 
41 41 41 10 10 10 10 10 10 10 10 11 10 41 41 41 10 10 10 10 14 25 12 12 13 12 13 13 12 24 16 10 10 10 10 10 10 10 10 10 10 10 10 10 10 10 10 10 10 10 
41 41 41 41 41 10 41 41 41 10 10 10 41 41 41 41 41 41 10 10 17 12 12 12 12 12 12 13 12 12 18 10 10 10 10 10 10 10 10 10 10 10 10 10 10 10 10 10 10 10 
41 41 41 41 41 41 41 41 41 41 41 41 41 41 41 41 41 41 41 14 25 12 12 13 13 12 12 13 12 12 18 10 10 10 10 10 10 10 10 10 10 10 10 10 10 10 10 10 10 10 
